1111111111111111111111111111111111
1E000000000000000000000000C0000001
1010010100100000101001000000010101
1010010010101010001001000000010101
111111111111111111111111P111111111
1111111111111111111111111111111111